[4, 4, 5, 1, 3, 0, 4, 4, 2, 2]
[2, 0, 5, 3, 1, 2, 5, 3, 0, 4]
[5, 1, 1, 5, 1, 5, 0, 5, 2, 2]
[0, 2, 5, 1, 4, 1, 3, 3, 3, 5]
[0, 2, 4, 1, 2, 3, 3, 0, 5, 5]
[2, 4, 3, 5, 1, 0, 5, 3, 0, 0]
[5, 0, 4, 5, 5, 1, 1, 1, 3, 3]
[4, 0, 5, 1, 3, 4, 2, 5, 1, 0]
[0, 2, 4, 1, 0, 1, 2, 2, 4, 1]
[3, 0, 5, 2, 1, 5, 5, 5, 0, 1]